*******
*     *
* *****
*     *
***** *
*     *
* *** *
* *  H*
*******
